üîπ –ß–∞—Å—Ç–æ —É–ø–æ—Ç—Ä–µ–±–ª—è–µ–º—ã–µ –≤–æ–∑–≤—Ä–∞—Ç–Ω—ã–µ –≥–ª–∞–≥–æ–ª—ã (—Å sich)
–ì–ª–∞–≥–æ–ª (–∏–Ω—Ñ–∏–Ω–∏—Ç–∏–≤)	–ü–µ—Ä–µ–≤–æ–¥	–ü—Ä–∏–º–µ—Ä
sich freuen	—Ä–∞–¥–æ–≤–∞—Ç—å—Å—è	Ich freue mich auf das Wochenende.
sich erinnern	–≤—Å–ø–æ–º–∏–Ω–∞—Ç—å	Erinnerst du dich an ihn?
sich beeilen	—Å–ø–µ—à–∏—Ç—å	Wir m√ºssen uns beeilen.
sich setzen	—Å–∞–¥–∏—Ç—å—Å—è	Setzt euch bitte!
sich interessieren	–∏–Ω—Ç–µ—Ä–µ—Å–æ–≤–∞—Ç—å—Å—è	Er interessiert sich f√ºr Kunst.
sich f√ºhlen	—á—É–≤—Å—Ç–≤–æ–≤–∞—Ç—å —Å–µ–±—è	Ich f√ºhle mich heute m√ºde.
sich entspannen	—Ä–∞—Å—Å–ª–∞–±–ª—è—Ç—å—Å—è	Am Abend entspanne ich mich.
sich waschen	—É–º—ã–≤–∞—Ç—å—Å—è, –º—ã—Ç—å—Å—è	Er w√§scht sich jeden Morgen.
sich anziehen	–æ–¥–µ–≤–∞—Ç—å—Å—è	Ich ziehe mich schnell an.
sich ausziehen	—Ä–∞–∑–¥–µ–≤–∞—Ç—å—Å—è	Sie zieht sich langsam aus.
sich vorstellen	–ø—Ä–µ–¥—Å—Ç–∞–≤–ª—è—Ç—å—Å—è / –ø—Ä–µ–¥—Å—Ç–∞–≤–ª—è—Ç—å	Ich stelle mich vor. ‚Äî –Ø –ø—Ä–µ–¥—Å—Ç–∞–≤–ª—è—é—Å—å.
Ich stelle mir das vor. ‚Äî –Ø –ø—Ä–µ–¥—Å—Ç–∞–≤–ª—è—é —Å–µ–±–µ —ç—Ç–æ.
sich beschweren	–∂–∞–ª–æ–≤–∞—Ç—å—Å—è	Sie beschwert sich √ºber das Essen.
sich bedanken	–±–ª–∞–≥–æ–¥–∞—Ä–∏—Ç—å	Ich bedanke mich bei dir.
sich entschuldigen	–∏–∑–≤–∏–Ω—è—Ç—å—Å—è	Er entschuldigt sich f√ºr die Versp√§tung.
sich verlieben	–≤–ª—é–±–ª—è—Ç—å—Å—è	Sie hat sich in ihn verliebt.
sich treffen	–≤—Å—Ç—Ä–µ—á–∞—Ç—å—Å—è	Wir treffen uns um acht.
sich k√ºmmern (um)	–∑–∞–±–æ—Ç–∏—Ç—å—Å—è (–æ)	Ich k√ºmmere mich um die Kinder.
sich langweilen	—Å–∫—É—á–∞—Ç—å	Die Kinder langweilen sich.
sich sch√§men	—Å—Ç—ã–¥–∏—Ç—å—Å—è	Er sch√§mt sich f√ºr sein Verhalten.
üî∏ –ó–∞–º–µ—á–∞–Ω–∏—è:
–í–æ–∑–≤—Ä–∞—Ç–Ω–æ–µ –º–µ—Å—Ç–æ–∏–º–µ–Ω–∏–µ —Å–æ–≥–ª–∞—Å—É–µ—Ç—Å—è –ø–æ –ª–∏—Ü—É —Å –ø–æ–¥–ª–µ–∂–∞—â–∏–º.
–ù–µ–∫–æ—Ç–æ—Ä—ã–µ –≥–ª–∞–≥–æ–ª—ã –º–æ–≥—É—Ç –±—ã—Ç—å –∫–∞–∫ –≤–æ–∑–≤—Ä–∞—Ç–Ω—ã–º–∏, —Ç–∞–∫ –∏ –Ω–µ –≤–æ–∑–≤—Ä–∞—Ç–Ω—ã–º–∏ (–Ω–∞–ø—Ä–∏–º–µ—Ä, setzen ‚Äî —Å–∞–∂–∞—Ç—å –∫–æ–≥–æ-—Ç–æ, sich setzen ‚Äî —Å–∞–¥–∏—Ç—å—Å—è —Å–∞–º–æ–º—É).
–ù–µ–∫–æ—Ç–æ—Ä—ã–µ –≥–ª–∞–≥–æ–ª—ã —Ç—Ä–µ–±—É—é—Ç –¥–æ–ø–æ–ª–Ω–∏—Ç–µ–ª—å–Ω–æ–≥–æ —É–ø—Ä–∞–≤–ª–µ–Ω–∏—è (–Ω–∞–ø—Ä–∏–º–µ—Ä, sich interessieren f√ºr, sich k√ºmmern um).
